NO ./assets/xpms/64/4.xpm           
SO ./assets/xpms/256/05.xpm
WE ./assets/xpms/64/3.xpm
EA ./assets/xpms/64/1.xpm

F 10,200,50
C 0,50,100                

11111
1E001
1111111111