C 0,50,200      
NO ./assets/xpms/64/4.xpm           
SO ./assets/xpms/256/05.xpm
WE           ./assets/xpms/64/3.xpm

F 10,       200, 50

EA ./assets/xpms/64/1.xpm



1111111111111111111111111111111111111111
1010000000000000000000010000000000000001
1010100000101000000000000000000010000001
1010100000100100000000000000000010000001
1010100000010010000000000000000011111111
101010000000100111110000000000001
101011111111111111111111000000001
1010100000000000000N0000000000001
101010000000000000011110000000001
100010000000000000010010100100001
111110111111111111111111111111111
10010000001
10000010001
10001000101
11111111111
101