NO ./assets/xpms/64/test.xpm
SO ./assets/xpms/64/test.xpm
WE ./assets/xpms/64/test.xpm
EA ./assets/xpms/64/test.xpm

F 10,10,10
C 20,20,20 

111111
10W000
111111