NO ./assets/xpms/64/test.xpm
SO ./assets/xpms/64/test.xpm
WE ./assets/xpms/64/test.xpm
EA ./assets/xpms/64/test.xpm

F 10,10
C 20,20,20

11111111111111
100000100000001
1001000100010001
10001000100010001
 10001000100010001
  1N001000000010001
   111111111111111